00000000000
11110111110
01100110010
01111111110
00000000010