00000000010
11100011110
01100110000
01111111110
00000000000